////////..////////
////////..////////
////////..////////
///............///
///............///
///.....//.....///
///.....//.....///
///.....//.....///
///.....//.....///
///..////////..///
///@...........///
//////////////////
//////////////////
//////////////////