//////..//////
/............/
/..........*./
/.....//...../
/.....//...../
/...*.//...../
/.....//......
/.....//......
/...//////.../
/...//////.../
/............/
/......@...../
//////..//////